1111111111111
2000000000002
1110111010111
1110000000111
1110111011111
1110111111111
1110000000001
1111111011111
1111111001111
1111111111111