1111111111111
2000111110111
1110111010111
1110000000111
1110111011111
1110111111111
1110000000002
1111111111111

